#domain
hospital
#levelname
CustomLevel_2
#colors
blue: 0,B,A,C
#initial
++++++++++++++
+0  +    +   +
+ +    + +B+ +
+ ++ +   ++  +
+ +A   +  + ++
+ ++ + ++ + ++
+ +    +     +
+   +  + +C+ +
++++++++++++++
#goal
++++++++++++++
+  A+    +   +
+ +    + + + +
+ ++ +   ++  +
+ +    +  + ++
+ ++ + ++ + ++
+ +    +     +
+   +  +B+ +C+
++++++++++++++
#end