#domain
hospital
#levelname
Agentix
#colors
blue: 0, A
green: 1, B
red: 2, C
#initial
+++++++++++++++++++++
+0  A               +
+                   +
+                   +
+                   +
+++++++++  ++++++++++
+     2  C          +
+++++++++  ++++++++++
+                   +
+                   +
+                   +
+               B  1+
+++++++++++++++++++++
#goal
+++++++++++++++++++++
+               A   +
+                   +
+                   +
+                   +
+++++++++  ++++++++++
+                   +
+++++++++  ++++++++++
+                   +
+                   +
+   C               +
+   B               +
+++++++++++++++++++++
#end