#domain
hospital
#levelname
AIegean
#colors
Blue: 0, A
Red: 1, B
Cyan: 2, C
Purple: 3, D
Green: 4, E
Orange: 5, F
Pink: 6, G
Lightblue: 7, H
Brown: 8, I
Grey: 9, J
#initial
++++++++++++++++++++++++++++++++++++++++++++++
++++++++++++++++++++++++++++++++++++++++++++++
+++++++++++++                            +++++
+++++++++++++                         ++++++++
+++++++++++++ 0   6   1    ++++ 7     ++++++++
+++++++++++++ A   G   B    +  + H     ++++++++
+++++++ + +      ++      ++           ++++++++
++++++        +++                      +++++++
++++++   +    +++                  +   +++++++
++++++   +                         +  ++++++++
++++++   +         ++        C2++  +  ++++++++
+++      +         ++          ++  +  ++++++++
+++  +   + 3D      +++++++       +++  ++++++++
+++      +         ++++  +       +++       +++
+++  +   +            ++ +         +   ++  +++
++++ +   +                         +  ++++++++
+        +  8                 9 ++ +  ++++++++
++++++   +  I +++     +++     J ++ +  ++++++++
++++++   +    +++     +++          +   +++++++
++++++   +                      ++ +   +++++++
++++++   +                      ++ +    ++++++
++++++   +        E         F  ++  +    ++++++
++++++   ++       4         5      +  ++++++++
+ +  +   ++++++               ++++++         +
+       ++++++++++ +++++++++ ++++++++        +
+       ++++++++++ +++++++++ ++++++++        +
+       ++++++++++ +++++++++ ++++++++        +
+                                            +
+                                            +
++++++++++++++++++++++++++++++++++++++++++++++
#goal
++++++++++++++++++++++++++++++++++++++++++++++
++++++++++++++++++++++++++++++++++++++++++++++
+++++++++++++                            +++++
+++++++++++++                         ++++++++
+++++++++++++              ++++       ++++++++
+++++++++++++              +E +       ++++++++
+++++++ + +      ++      ++           ++++++++
++++++        +++                      +++++++
++++++   +    +++                  +   +++++++
++++++   +                         +  ++++++++
++++++   +         ++          ++  +  ++++++++
+++C     +         ++          ++  +  ++++++++
+++  +   +         +++++++       +++  ++++++++
+++      +         ++++F +       +++     D +++
+++ A+   +            ++ +         +   ++  +++
++++ +   +                         +  ++++++++
+        +                      ++ +  ++++++++
++++++   +    +++     +++       ++ +  ++++++++
++++++   +    +++     +++          +   +++++++
++++++   +                      ++ +   +++++++
++++++   +                      ++ +    ++++++
++++++   +                     ++  +   B++++++
++++++   ++                        +  ++++++++
+ +  +   ++++++               ++++++         +
+       ++++++++++ +++++++++ ++++++++        +
+       ++++++++++ +++++++++ ++++++++        +
+       ++++++++++ +++++++++ ++++++++        +
+                                            +
+             I   G         H   J            +
++++++++++++++++++++++++++++++++++++++++++++++
#end
