#domain
hospital
#levelname
AlBarah
#colors
blue: 0,6,G,M
red: 1,7,H,N
cyan: 2,I
purple: 3,J
pink: 4,K
grey: 5,L
green: O
#initial
++++++++++++++++++++
+0   G  +  L    5  +
+ ++ ++ + ++ ++    +
+ 6M +     + N  7  +
++++ +++ +++ +++   +
+1   H     K   4   +
+ ++ +++++++ ++    +
+    +     +       +
++++ + +++ + +++   +
+2   I     J   3   +
+ ++ +++++++ ++    +
+    +     +       +
++++ +++ +++ +++   +
+                  +
+              OO  +
++++++++++++++++++++
#goal
++++++++++++++++++++
+L      +   I      +
+ ++ ++ + ++ ++    +
+    +     +       +
++++ +++ +++ +++   +
+              H   +
+ ++ +++++++ ++    +
+    +     +       +
++++ + +++ + +++   +
+               G  +
+ ++ +++++++ ++    +
+    +     +       +
++++ +++ +++ +++   +
+  J     K         +
+                  +
++++++++++++++++++++
#end