#domain
hospital
#levelname
AlphaMAS
#colors
red:    0, A
blue:   1, B
green:  2, C
orange: 3, D
purple: 4, E
#initial
++++++++++++++++++++
+0 A     +    B  1 +
+   ++++  +  +     +
+ C +        + D   +
+   + ++++++ +     +
+     +    +       +
+ E   +    +   2   +
+   +++++  +       +
+3      +      4   +
+       +          +
+                  +
++++++++++++++++++++
#goal
++++++++++++++++++++
+        +  A      +
+   ++++  +  +     +
+ B +        +     +
+   + ++++++ +     +
+     +    +  D    +
+     +    +       +
+   +++++  +       +
+       +   C      +
+       +      E   +
+                  +
++++++++++++++++++++
#end
