#domain
hospital
#levelname
Apdo
#colors
red: 0, Q
blue: 1, B
cyan: 2, C
green: 3, 5, A, E, H
orange: 4, P, O, D
lightblue: V
grey: 7, Z
purple: 6, 8, 9, F, I, T, Y
#initial
+++++++++++++++++++++++++++++++++++++++++++++++
+      4           +++++++                    +
+           F    +    +    +                  +
+                +    +    +                  +
+                +    +    +  I               +
+                +   POD   +                  +
+                +VVVVVVVVV+   T              +
+                6   V2V                      +
+                    VCV                      +
+               VVVVVV VVVVVV                 +
+             T V0Q   7   B1V                 +
+               VVVVVVZVVVVVV        5        +
+                    VHV                      +
+                    V3V           A          +
+                 VVVVVVVVV    Y              +
+     POD             +      E                +
+                     +                       +
+++++++++++++++++++++ + ++++++++++++ ++++++++++
+                     +                       +
+ +++++++++++++++++++ + +++++++++++++++++++++ +
+ +                   +                     + +
+ + +++++++++++++++++++++++++++++++++++++++ + +
+ +                   +                     + +
+ +++++++++++++++++++ + +++++++++++++++++++++ +
+                     +                       +
+++++++ +++++++++++++ + +++++++++++++ +++++++++
+       +             +             +         +
+ +++++++ +++++++++++++++++++++++++++ +++++++ +
+ +                   +                     + +
+++++++++++++++++++++ + +++++++++++++++++++++++
+ 9                   +                       +
+                     +     8                 +
+++++++++++++++++++++++++++++++++++++++++++++++
#goal
+++++++++++++++++++++++++++++++++++++++++++++++
+                  +++++++    FITTY           +
+                +    +    +                  +
+                +    +    +                  +
+                +    +    +                  +
+                +         +                  +
+                +VVVVVVVVV+                  +
+                    VHV             DOPE     +
+                    V V                      +
+               VVVVVV VVVVVV                 +
+               VB         QV                 +
+               VVVVVV7VVVVVV                 +
+                    V V                      +
+    DOPA            VCV                      +
+                 VVVVVVVVV                   +
+                     +                       +
+                     +                       +
+++++++++++++++++++++ + ++++++++++++4++++++++++
+                     +                       +
+ +++++++++++++++++++ + +++++++++++++++++++++ +
+ +                   +                     + +
+ + +++++++++++++++++++++++++++++++++++++++ + +
+ +                   +                     + +
+ +++++++++++++++++++ + +++++++++++++++++++++ +
+                     +                       +
+++++++ +++++++++++++ + +++++++++++++ +++++++++
+       +             +             +         +
+ +++++++ +++++++++++++++++++++++++++ +++++++ +
+ +                   +                     + +
+++++++++++++++++++++ + +++++++++++++++++++++++
+                     +                       +
+6                   8+9                     5+
+++++++++++++++++++++++++++++++++++++++++++++++
#end