#domain
hospital
#levelname
AssertFun
#colors
blue: 0, B
red: 1, A
purple: 2, C
#initial
+++++++++++++++++++++++++++++
+   C                   C   +
+ 1 CCCCCCCCCC CCCCCCCCCC 0 +
+   C  C  C  C C  C  C  C   +
+   C  C  C  C C  C  C  C   +
+  CC  C  C  C C  C  C  CC  +
+      C  C  C C  C  C      +
+      C  C  C C  C  C      +
+  CCCCC  C  C C  C  CCCCC  +
+         C  C C  C         +
+         C  C C  C         +
+  CCCCCCCC  C C  CCCCCCCC  +
+            C C            +
+            C C            +
+  CCCCCCCCCCC CCCCCCCCCCC  +
+  C         C C         C  +
+  C         C C         C  +
+  C         C C         C  +
+  C         C C         C  +
+            C C            +
+  C         C C         C  +
+CCC         C C         CCC+
+        CCCCC CCCCC        +
+        C         C        +
+        C CCCCCCC C        +
+ C      C CBABABC C      C +
+ C C    C CA C AC C    C C +
+ CCCCCCCC CB 2CBC CCCCCCCC +
+          CA C AC          +
+++++++++++++++++++++++++++++
#goal
+++++++++++++++++++++++++++++
+    1                 0    +
+                           +
+                           +
+                           +
+                           +
+                           +
+                           +
+                           +
+                           +
+                           +
+                           +
+                           +
+                           +
+                           +
+                           +
+                           +
+                           +
+                           +
+                           +
+                           +
+                           +
+                           +
+                           +
+                           +
+                           +
+                           +
+                           +
+                           +
+++++++++++++++++++++++++++++
#end
