#domain
hospital
#levelname
BigForty
#colors
red: 0, A
green: 1, B
blue: 2, C
purple: 3, D
orange: 4, E
cyan: 5, F
pink: 6, G
brown: 7, H
#initial
+++++++++++++++++++++++++++
+01++324657+              +
+AB++DCFEHG+              +
+  +     +     +     +    +
+ + + + + + + + + + + + + +
+                         +
++++++++++       ++++++++++
+                         +
++++++ ++++++ ++++++ ++++++
+                         +
+++++ ++++++ ++++++ +++++++
+       +         +       +
+                         +
+    +++      +      +    +
+           + +            +
+                         +
+++++++++++++++++++++++++++
#goal
+++++++++++++++++++++++++++
+  ++      +              +
+  ++      +              +
+  +     +     +     +    +
+ +A+ + +B+ + +C+ + +D+ + +
+                         +
++++++++++       ++++++++++
+                         +
++++++ ++++++ ++++++ ++++++
+                         +
+++++ ++++++ ++++++ +++++++
+       +         +       +
+                         +
+    +++      +      +    +
+           + +            +
+  E   F   G   H          +
+++++++++++++++++++++++++++
#end
