#domain
hospital
#levelname
BoxBender
#colors
blue: 8,A,6,E,D,C,P,0,9,F
red: B,7,S,L,1
purple: 2,3,4,5
#initial
+++++++++++++++++++++++++++++        
+              8AB    +  6  +        
+ ++++++++++++  +++++++E+ + +        
+ +++++++++++++++++++++D+ + +        
+ +               +   +C+ + +        
+ +              +   ++P+ + +        
+ +             +   + +A+ + +        
+ +     7      +   +  +++++++++++++++
+ +           +   +   +        +SLB0+
+ +          +   +    +        +    +
+         +++   +     +        +    +
+         ++23++      +        +    +
+         ++45++      +        +    +
+        +   +++      +      +      +
+       +   +         +             +
+      +   +          +      +      +
+     +   +           +    +        +
+    +   +            +    +        +
+   +   +             +    +        +
+++++++++++++++++++++++    +        +
       ++  9  ++       1FCP+        +
     +++  +A+  ++++++++++++++++++++++
     +    +A+    +                   
    ++    +A+    ++                  
    +     +A+     +                  
    +     +A+     +                  
   ++   +++A+++   ++                 
   +   +AAAAAAA+   +                 
   +    +AAAAA+    +                 
   +     +AAA+     +                 
   +  +++ + + +++  +                 
   ++ + +  +  + + ++                 
    +             +                  
    ++           ++                  
     ++         ++                   
      ++       ++                    
       ++     ++                     
         +++++                       
#goal
+++++++++++++++++++++++++++++        
+                  AB +     +        
+ ++++++++++++  +++++++ + +E+        
+ +++++++++++++++++++++ + +D+        
+ +               + 45+ + +C+        
+ +              +   ++ + +P+        
+ +             +   + + + +A+        
+8+            +   +  +++++++++++++++
+7+           +   +   +        +FCP +
+ +          +   +    +        +    +
+         +++   +     +        +    +
+         ++  ++      +        +    +
+         ++  ++      +        +    +
+        +   +++      +      +      +
+       +   +         +     10      +
+      +   +          +      +      +
+     +   +           +    +        +
+    +   +            +    +        +
+   +23 +             +    +        +
+++++++++++++++++++++++    +        +
       ++     ++        SLB+        +
     +++  + +  ++++++++++++++++++++++
     +    + +    +                   
    ++    + +    ++                  
    +     + +     +                  
    +     + +     +                  
   ++   +++ +++   ++                 
   +   +       +   +                 
   +    +     +    +                 
   +     +   +     +                 
   +  +++ +A+ +++  +                 
   ++ + +  +  + + ++                 
    +             +                  
    ++           ++                  
     ++         ++                   
      ++       ++                    
       ++     ++                     
         +++++                       
#end