#domain
hospital
#levelname
BStar
#colors
blue: Q,0
purple: 3,D
green: 2,E
cyan: F,1
#initial
+++++++++++++
+  Q    +++++
+3 ++++ +++ +
+  +2 + +++ +
+0 +DD+ F + +
++++    + + +
++++1   F E +
+++++++++++++
#goal
+++++++++++++
+       +++++
+  ++++ +++0+
+  +  + +++ +
+  +  +   + +
++++    + + +
++++        +
+++++++++++++
#end