#domain
hospital
#levelname
ClauDOom
#colors
orange: A,0
red: B,1
blue: 2,C
pink: G,6
green: 3,D
purple: E,4
cyan: F,5
#initial
+++++++++++++++++++++++++++++++++++++++++++++++++
+++++++++++++++++AAA+++++++++++++++++++++++++++++
+++++++++++++++++AAA+++++++++++++++++++++++++++++
+++++++++++++++++AAA+++++++++++++++++++++++++++++
++++++++++++++++++AAA++++++++A+++++++++++++++++++
++++++++++++++++++ A +++++++ABA++++++++++++++++++
++++++++++++++++++AAA+++++++A A++++++++++++++++++
++++++++++++++++++AA +++++++ 2 ++++++++++++++++++
+++++++++++++++++++ AA+++++A  +++++++++++++++++++
++++++++++A++++++++AAA+++++A A++++++++A++++++++++
+++++++++AG +++++++ A +++++   +++++++AAA+++++++++
++++++++++   +++++++ A +++A  +++++++ AA++++++++++
+++++++++++ 1 ++++++AAA+++A A++++++AAA+++++++++++
++++++++++++   +++++ A +++A A+++++AA ++++++++++++
+++++++++++++   ++++AAA+++  A++++ A +++++++++++++
++++++++++++++A  ++++AAA+A A++++AAA++++++++++++++
+++++++++++++++  A+++AAA+A A+++ A +++++++++++++++
++++++++++++++++  A++AAA+A A++AAA++++++++++++++++
+++++AA +++++++++  A+ A +A A+ A +++++++++ AA+++++
++++AAAA A +++++++  A+A A  + AA+++++++ A 3 EA++++
+++++ A AAA A A++++    AA  A  ++++A A     AA+++++
++++++++ A AAAAA   + A  A  A +         A ++++++++
+++++++++++ A AA          A       A A +++++++++++
+++++++++++++++A     A         AAA+++++++++++++++
+++++++++++++++++++A    0    A+++++++++++++++++++
+++++++++++++++A   A        A    A+++++++++++++++
+++++++++++ A      A             AAAAA+++++++++++
++++++++ A         +         +   AAAAAAAA++++++++
+++++AA     AAA++++     A     ++++AAAAAAAAAA+++++
++++AF 6 AA++++ ++A  + AAA +A A+++++++AAAAAAA++++
+++++AA +++++++++A A+A A+AAA+   +++++++++AAA+++++
++++++++++++++++ AA++A A+AAA++A A++++++++++++++++
+++++++++++++++AAA+++A A+AAA+++   +++++++++++++++
++++++++++++++ A ++++  A+AAA++++A A++++++++++++++
+++++++++++++AAA++++A  +++AAA++++   +++++++++++++
++++++++++++ A +++++A A+++AAA+++++A  ++++++++++++
+++++++++++AAA++++++A A+++AAA++++++ 4 +++++++++++
++++++++++ A +++++++  A+++AAA+++++++   ++++++++++
+++++++++AAA+++++++A  +++++AAA+++++++ CA+++++++++
++++++++++A++++++++A A+++++AAA++++++++A++++++++++
+++++++++++++++++++  A+++++AAA+++++++++++++++++++
++++++++++++++++++A5 +++++++AAA++++++++++++++++++
++++++++++++++++++A A+++++++AAA++++++++++++++++++
++++++++++++++++++ADA+++++++AAA++++++++++++++++++
+++++++++++++++++++A+++++++++A+++++++++++++++++++
+++++++++++++++++++++++++++++++++++++++++++++++++
+++++++++++++++++++++++++++++++++++++++++++++++++
+++++++++++++++++++++++++++++++++++++++++++++++++
+++++++++++++++++++++++++++++++++++++++++++++++++
#goal
+++++++++++++++++++++++++++++++++++++++++++++++++
+++++++++++++++++AAA+++++++++++++++++++++++++++++
+++++++++++++++++AAA+++++++++++++++++++++++++++++
+++++++++++++++++AAA+++++++++++++++++++++++++++++
++++++++++++++++++AAA++++++++A+++++++++++++++++++
++++++++++++++++++ A +++++++AEA++++++++++++++++++
++++++++++++++++++AAA+++++++A A++++++++++++++++++
++++++++++++++++++AA +++++++   ++++++++++++++++++
+++++++++++++++++++ AA+++++A  +++++++++++++++++++
++++++++++A++++++++AAA+++++A A++++++++A++++++++++
+++++++++AB +++++++ A +++++   +++++++AAA+++++++++
++++++++++   +++++++ A +++A  +++++++ AA++++++++++
+++++++++++   ++++++AAA+++A A++++++AAA+++++++++++
++++++++++++   +++++ A +++A A+++++AA ++++++++++++
+++++++++++++   ++++AAA+++  A++++ A +++++++++++++
++++++++++++++A  ++++AAA+A A++++AAA++++++++++++++
+++++++++++++++  A+++AAA+A A+++ A +++++++++++++++
++++++++++++++++  A++AAA+A A++AAA++++++++++++++++
+++++AA +++++++++  A+ A +A A+ A +++++++++ AA+++++
++++AAAA A +++++++  A+A A  + AA+++++++ A   CA++++
+++++ A AAA A A++++    AA  A  ++++A A   4 AA+++++
++++++++ A AAAAA   + A  A  A +         A ++++++++
+++++++++++ A AA          A       A A +++++++++++
+++++++++++++++A     A         AAA+++++++++++++++
+++++++++++++++++++A    0    A+++++++++++++++++++
+++++++++++++++A   A        A    A+++++++++++++++
+++++++++++ A      A             AAAAA+++++++++++
++++++++ A         +         +   AAAAAAAA++++++++
+++++AA     AAA++++     A     ++++AAAAAAAAAA+++++
++++AG   AA++++ ++A  + AAA +A A+++++++AAAAAAA++++
+++++AA +++++++++A A+A A+AAA+   +++++++++AAA+++++
++++++++++++++++ AA++A A+AAA++A A++++++++++++++++
+++++++++++++++AAA+++A A+AAA+++   +++++++++++++++
++++++++++++++ A ++++  A+AAA++++A A++++++++++++++
+++++++++++++AAA++++A  +++AAA++++   +++++++++++++
++++++++++++ A +++++A A+++AAA+++++A  ++++++++++++
+++++++++++AAA++++++A A+++AAA++++++   +++++++++++
++++++++++ A +++++++  A+++AAA+++++++   ++++++++++
+++++++++AAA+++++++A  +++++AAA+++++++ DA+++++++++
++++++++++A++++++++A A+++++AAA++++++++A++++++++++
+++++++++++++++++++  A+++++AAA+++++++++++++++++++
++++++++++++++++++A  +++++++AAA++++++++++++++++++
++++++++++++++++++A A+++++++AAA++++++++++++++++++
++++++++++++++++++AFA+++++++AAA++++++++++++++++++
+++++++++++++++++++A+++++++++A+++++++++++++++++++
+++++++++++++++++++++++++++++++++++++++++++++++++
+++++++++++++++++++++++++++++++++++++++++++++++++
+++++++++++++++++++++++++++++++++++++++++++++++++
+++++++++++++++++++++++++++++++++++++++++++++++++
#end
