#domain
hospital
#levelname
CudBSlvd
#colors
blue: 0, A
green: 1, B
cyan: 2, C
purple: 3, E
pink: 4, F
red: D
#initial
++++++++++++++++++++++++++++++++++++++++++++++++++
++++++++++++++++++++++++++++++++++++++++++++++++++
++++++++++++++++++++++++++  ++++++++++++++++++++++
+++++++++++++++++++++++++  +++++++++++++++++++++++
+++++++++++++++++++++++    +++++++++++++++++++++++
++++++++++++++++++++++      ++++++++++++++++++++++
+++++++++++++++++++++       ++++++++++++++++++++++
+++++++++++++++++++++       ++++++++++++++++++++++
+++++++++++++++++++++       ++DD++++++++++++++++++
++++++++++++++++++++       +++++++++++++++++++++++
+++++++++++++++3+++        +++++++++++++++++++++++
++++++++++++              ++++++++++++++++++++++++
+++++++++++         +     ++++++++++++++++++++++++
++++++++++     ++         ++++++++++++++++++++++++
++++++++++     +         +++++++++++++++++++++++++
++++++++++  +   +        +++++++++++++++++++++++++
+++++++++                 ++++++++++++++++++++++++
+++++++++   +             ++++++++++++++++++++++++
+++++++++ ++E+   +     +  ++++++++++++++++++++++++
+++++++++                 ++++++++++++++++++++++++
+++++++++                     ++++++++++++++++++++
+++++++++                      +++++++++++++++++++
++++++++++                    ++++++++++++++++++++
+++++++++                     ++++++++++++++++++++
+++++++++                 +  +++++++++++++++++++++
+++++++++                +   +++++++++++++++++++++
++++++++++               ++ +++++++++++ 4  +++++++
++++++++++               +++++++++++++     +++++++
+++++++++++              ++ ++++++    +    +++++++
+++++++++F+              +++++++ ++ ++     +++++++
+++++++++             +  ++ ++++++ C+      +++++++
+++++++++               + ++++++           +++++++
+++++++++               +++++++             ++++++
+++++++++            ++++++++++              +++++
+++++++++             +++  +1+++       2 +++++++++
++++++++++            +    + +++        ++++++++++
++++++++++++          B      +++         +++++++++
+++++++++++D+        +DDDDDDD+++          ++++++++
+++++++++++++        B        +++         ++++++++
+++++++++++ +        +        AC        ++++++++++
+++++++++++          +++     +D+++++    ++++++++++
+++++++++++ +       ++++     +D++++++   ++++++++++
+++++++++++++      +  ++0+++DD+++++++   +  +++++++
+++++++++++++           +++D+D++ +++     +++++++++
+++++++++++++++       + +DD+DD+   ++    ++++++++++
+++++++++++++++++  +++++++D+D++         ++++++++++
++++++++++++++++++++++++++++D+++       +++++++++++
+++++++++++++++++++++++++++++++++     ++++++++++++
++++++++++++++++++++++++++++++++++++++D+++++++++++
++++++++++++++++++++++++++++++++++++++++++++++++++
#goal
++++++++++++++++++++++++++++++++++++++++++++++++++
++++++++++++++++++++++++++++++++++++++++++++++++++
++++++++++++++++++++++++++  ++++++++++++++++++++++
+++++++++++++++++++++++++  +++++++++++++++++++++++
+++++++++++++++++++++++    +++++++++++++++++++++++
++++++++++++++++++++++      ++++++++++++++++++++++
+++++++++++++++++++++       ++++++++++++++++++++++
+++++++++++++++++++++       ++++++++++++++++++++++
+++++++++++++++++++++       ++  ++++++++++++++++++
++++++++++++++++++++       +++++++++++++++++++++++
+++++++++++++++ +++        +++++++++++++++++++++++
++++++++++++              ++++++++++++++++++++++++
+++++++++++         +     ++++++++++++++++++++++++
++++++++++     ++         ++++++++++++++++++++++++
++++++++++     +         +++++++++++++++++++++++++
++++++++++  +   +        +++++++++++++++++++++++++
+++++++++                 ++++++++++++++++++++++++
+++++++++   +             ++++++++++++++++++++++++
+++++++++ ++ +   +     +  ++++++++++++++++++++++++
+++++++++                 ++++++++++++++++++++++++
+++++++++                     ++++++++++++++++++++
+++++++++                      +++++++++++++++++++
++++++++++                    ++++++++++++++++++++
+++++++++                     ++++++++++++++++++++
+++++++++                 +  +++++++++++++++++++++
+++++++++                +   +++++++++++++++++++++
++++++++++               ++ +++++++++++    +++++++
++++++++++               +++++++++++++     +++++++
+++++++++++              ++ ++++++4  3+    +++++++
+++++++++ +              +++++++ ++F++     +++++++
+++++++++             +  ++ ++++++C +      +++++++
+++++++++               + ++++++           +++++++
+++++++++               +++++++             ++++++
+++++++++            ++++++++++            E +++++
+++++++++             +++B +0+++         +++++++++
++++++++++            +    + +++        ++++++++++
++++++++++++                 +++         +++++++++
+++++++++++ +        +       +++          ++++++++
+++++++++++++                 +++         ++++++++
+++++++++++2+        +                  ++++++++++
+++++++++++C         +++     + +++++    ++++++++++
+++++++++++B+       ++++     + ++++++   ++++++++++
+++++++++++++      +1 ++ +++  +++++++   +  +++++++
+++++++++++++           +++ + ++ +++     +++++++++
+++++++++++++++       + +  +  +   ++    ++++++++++
+++++++++++++++++A +++++++ + ++         ++++++++++
++++++++++++++++++++++++++++ +++       +++++++++++
+++++++++++++++++++++++++++++++++     ++++++++++++
++++++++++++++++++++++++++++++++++++++ +++++++++++
++++++++++++++++++++++++++++++++++++++++++++++++++
#end