#domain
hospital
#levelname
DayBreak
#colors
red: B,1
blue: A,0
cyan: C,2
lightblue: D,3
brown: E,4
#initial
++++++++++++++++++++
+    BA  +     +++++
+ ++++++ +     +++++
+1++++++C+     +++++
+0++++++D+     +++++
+ ++++++E+     +++++
+    EA+B+     +++++
+4    ++A+     +++++
+2    ++++++   +++++
+3    ++++++   +++++
+     ++++++   +++++
+     ++++++   +++++
+     ++++++   +++++
+              +++++
++++++++++++++++++++
#goal
++++++++++++++++++++
+  0   BA+     +++++
+ ++++++ +B    +++++
+ ++++++ +E    +++++
+ ++++++ +D    +++++
+ ++++++ +A    +++++
+      + +C    +++++
+     ++ +     +++++
+     ++++++   +++++
+     ++++++   +++++
+     ++++++   +++++
+     ++++++   +++++
+     ++++++   +++++
+     E    A   +++++
++++++++++++++++++++
#end