#domain
hospital
#levelname
Dolor
#colors
cyan: 0,A,K,3
blue: B,1, 2,L
brown: M,R,7
lightblue: S,5,N
pink: 6,P,Q
grey: O,4,T
#initial
++++++++++++++++++++
+0A++++++++++++++  +
+  ++++++A+++++++  +
+                 ++
+  +++++++++B++++  +
+1B++++++++++++++  +
+++++ M  S   R  ++++
+2K+       +  5+++++
+ ++6 +    ++      +
+  +  +    O  ++7 ++
+  +  +    +  P    +
+ ++  ++ N+++ ++  ++
+3L+  4  Q   T     +
++++++++++++++++++++
#goal
++++++++++++++++++++
+  ++++++++++++++A1+
+  ++++++ +++++++  +
+                 ++
+  +++++++++ ++++  +
+  ++++++++++++++B0+
+++++           ++++
+  +       +   +++++
+ ++  +MNOP++      +
+3L+  +QRST   ++  ++
+2K+  +    +       +
+ ++  ++  +++ ++  ++
+  +               +
++++++++++++++++++++
#end