#domain
hospital
#levelname
donut
#colors
blue: 0,1,A,B
red: 2,3,D,F
#initial
+++++++++++++++
++     +     ++
++  +++++++  ++
++ ++     ++ ++
+  +  +B+  +  +
+  + ++ ++ +  +
+1 0 A+ +F 2 3+
+  + ++ ++ +  +
+  +  +D+  +  +
++ ++     ++ ++
++  +++++++  ++
++     +     ++
+++++++++++++++
#goal
+++++++++++++++
++    F+B    ++
++  +++++++  ++
++ ++     ++ ++
+  +  + +  +  +
+  + ++ ++ +  +
+     + +     +
+  + ++ ++ +  +
+  +  + +  +  +
++ ++     ++ ++
++  +++++++  ++
++    D+A    ++
+++++++++++++++
#end