#domain
hospital
#levelname
Dracarys
#colors
grey: N,5
red: O,1
pink: M,4
brown: S,6
purple: 3,E
lightblue: K,2
green: P,0
#initial
++++++++++++++++++++++
+N       +++++       +
+       ++OOO++     M+
+      ++OOOOO++     +
+      OOOOOOOO+     +
+    +  OOOOOOO  +   +
+   ++    OOO    ++  +
+   +OOOO OOO OOOO++ +
+  ++OOOO OOO OOOOO+ +
+ ++OOOOO4    OOOOO+++
+++OOOOOO5    OOOOO ++
++++++++      ++++++++
+++                 ++
++++   S           +++
+3 6             +++ +
+   +           ++   +
+   ++ 1        +  K +
+    ++      E       +
+     ++      ++     +
+ 2    ++   +++      +
+       +++++    P 0 +
++++++++++++++++++++++
#goal
++++++++++++++++++++++
+        +++++       +
+       ++   ++      +
+      ++     ++     +
+     1        +0    +
+    +           +   +
+   ++           ++  +
+   +             ++ +
+  ++              + +
+ ++         6     +++
+++       NOM       ++
++++++++  S E ++++++++
+++       POK       ++
++++     5   2     +++
+   4            +++ +
+   +           ++   +
+   ++          +    +
+    ++        3     +
+     ++      ++     +
+      ++   +++      +
+       +++++        +
++++++++++++++++++++++
#end