#domain
hospital
#levelname
duckie
#colors
green: C,E,H,K,1
red: U,S,A,D,T,R,0
#initial
++++++++++++++++++++
+                  +
+ CUE SHACK DTU    +
+                  +
+ TREE 01          +
+                  +
++++++++++++++++++++
#goal
++++++++++++++++++++
+                  +
+ THE DUCKS ARE    +
+                  +
+ CUTE 01          +
+                  +
++++++++++++++++++++
#end
