#domain
hospital
#levelname
escAIpe
#colors
blue: 0,A,E,F,I,J,M
green: 6,L
purple: 5,K
red: 1,2,B,C
grey: 3,D
cyan: 4,G,H
#initial
++++++++++++
+        M6+
+ +++++ + ++
+ +++ +L+  +
+   +   + ++
+K+++A+ +  +
+ +   + ++++
+ + 0 +B13++
+ +   + +D++
+ +++++ C2++
+ +HGF+ ++++
+ +     E4++
+ +++++ ++++
+J   5+ + ++
+ +++++ + ++
+       I ++
++++++++++++
#goal
++++++++++++
+          +
+ +++++ + ++
+ +++ + + A+
+ K5+   + ++
+ +++ + + 0+
+ +   + ++++
+ +   +B13++
+ +   + +D++
+ +++++ C2++
+ +F G+E++++
+ +      H++
+I+++++ ++++
+    J+ +4++
+ +++++ + ++
+         ++
++++++++++++
#end