#domain
hospital
#levelname
GroupWon
#colors
blue: 0, A
red: 1, B
cyan: 2, C
purple: 3, D
green: 4, E
orange: 5, F
pink: 6, G
grey: 7, H
#initial
++++++++++++++++++++
+21+++ 3    7 H    +
+0A BC+ D          +
+ 4 +++   5 F      +
+++ +++++ ++++++ +++
+ 6 G +      +     +
+     +      +  E  +
+ +++ + ++++ + ++  +
+        +         +
++++++++++++++++++++
#goal
++++++++++++++++++++
+  +++    G       H+
+  A  +            +
+   +++     D      +
+++ +++++ ++++++ +++
+ C   +   E  + F   +
+     +      +     +
+ +++ + ++++ + ++  +
+        +         +
++++++++++++++++++++
#end
