#domain
hospital
#levelname
Indianish
#colors
red: 0, A
green: 1, B
blue: 2, C
purple:3, D,K
orange:4, E,J
cyan:5, F
pink:6, G
brown:7, H
grey:8, I
lightblue:9, S,N
#initial
+++++++++++++++++++++++++
+                        +
+ 0   3     2   7 + +    +
+   A   ++ ++++++ +D +   +
+ ++ 9+ G+E    H      +  +
+ 1 B   +++++++++ + 5+   +
+ ++C +6 +4     8   K+   +
+ +   S   F  J       +   +
+  ++ ++    ++  +++  +   +
+   +          ++ + +    +
+   ++ ++++++++++ + +    +
+   +          +  + +    +
+                 + +    +
+N      ++++++++++++++++ + 
+       I                +
+++++++++++++++++++++++++
#goal
+++++++++++++++++++++++++
+                        +
+        A        + +    +
+  B    ++ ++++++ +  +   +
+ ++  +  +    E      J+  +
+       +++++++++ +  +   +
+ ++  +  +           +   +
+ +C        G       K+   +
+  ++ ++    ++  +++  +   +
+   +          ++ + +    +
+   ++ ++++++++++ +F+    +
+   +          +  + +    +
+       INDSH     + +    +
+       ++++++++++++++++ +
+                        + 
+++++++++++++++++++++++++                  
#end             
