#domain
hospital
#levelname
KUTitans
#colors
red: 0, K, M
pink: 1, A
cyan: 2, U, Z
orange: 3, E
#initial
+++++++++++++++++++++++
++  0      + +    2  ++
++ +++++++++K+   U   ++
++A          +       ++
++ +++++++++ ++++++  ++
++1          + 3 E Z ++
++ +++++++++ ++++++  ++
++                   ++
++   +++++++  +++++  ++
++   +    M   +      ++
++   +        +      ++
++   +++++++  +++++  ++
++            +      ++
++   +++++    +++++  ++
++   +        +      ++
++   +        +      ++
++                   ++
++                   ++
++                   ++
+++++++++++++++++++++++
#goal
+++++++++++++++++++++++
++       A + +       ++
++ +++++++++ +       ++
++ K         +       ++
++ +++++++++ ++++++  ++
++           +    Z  ++
++ +++++++++ ++++++  ++
++             U     ++
++   +++++++  +++++  ++
++   +        +      ++
++   +        +      ++
++   +++++++  +++++  ++
++        M   +      ++
++   +++++    +++++  ++
++   +        +      ++
++   +        +      ++
++           E       ++
++                   ++
++                   ++
+++++++++++++++++++++++
#end
