#domain
hospital
#levelname
lilchal
#colors
blue: 0,A
red: 2,B,C,D,1
#initial
++++++++++++++++
+0  2+ +++++++ +
+++ ++ +A    + +
+++ ++         +
+++ ++ + BBC + +
+   +  +   D + +
+++ ++ ++++  + +
++   +    +  + +
++ +++ ++ ++ + +
+    +++  + 1+ +
+++ ++       + +
+    + + + + + +
+    + + + + + +
+    +++++++++ +
+              +
++++++++++++++++
#goal
++++++++++++++++
+    + +++++++ +
+++ ++ +    A+ +
+++ ++         +
+++ ++ +     + +
+   +  +     + +
+++ ++ ++++  + +
++D C+    +  + +
++ +++ ++ ++ + +
+    +++  +  + +
+++ ++       + +
+    + + + + + +
+    + + + + + +
+    +++++++++ +
+BB            +
++++++++++++++++
#end