#domain
hospital
#levelname
logo
#colors
red: D,T,U
purple: B,1
blue: 0,A
#initial
+++++++++++++++
+DD+++TTT++U+U+
+D+D+++T+++U+U+
+D+D+++T+++U+U+
+DD++++T++++U++
+++++++++++++++
++++ +++++ ++++
+++   +++   +++
+   B     1   +
+++   +++   +++
++++ +++++ ++++
++++ ++++++++++
++++ +++++ ++++
+++   +++   +++
+             +
+++   +++   +++
++++ +++++ ++++
++++++++++ ++++
++++ +++++ ++++
+++   +++   +++
+   0     A   +
+++   +++   +++
++++ +++++ ++++
+++++++++++++++
#goal
+++++++++++++++
+  +++   ++ + +
+ + +++ +++ + +
+ + +++ +++ + +
+  ++++ ++++ ++
+++++++++++++++
++++ +++++A++++
+++   +++   +++
+             +
+++   +++   +++
++++ +++++ ++++
++++ ++++++++++
++++ +++++ ++++
+++   +++   +++
+             +
+++   +++   +++
++++ +++++ ++++
++++++++++ ++++
++++ +++++ ++++
+++   +++   +++
+             +
+++   +++   +++
++++ +++++B++++
+++++++++++++++
#end