#domain
hospital
#levelname
LoopBots
#colors
red: A,0
blue: B,1
green: C,2
#initial
+++++++++++++++++++++++++++
+0  B   +        +      1++
+  ++++ + ++++++ + ++++  ++
+  +    +   A    +    +A ++
+  + ++ + ++++++ + ++ +  ++
+    ++ +    +   + ++    ++
++++    + A  + C + B  +++++
+2      +    +   +     C  ++
+  ++++ + ++++++ + ++++  ++
+  +    +      B +    +  ++
+  ++++ + ++++++ + ++++  ++
+     C                   ++
+++++++++++++++++++++++++++
#goal
+++++++++++++++++++++++++++
+0      +        +      1++
+  ++++ + ++++++ + ++++  ++
+  +    + C      +    +  ++
+  + ++ + ++++++ + ++ +  ++
+B   ++ +    +   + ++    ++
++++    +    +   +  B +++++
+2      + C  +   +        ++
+  ++++ + ++++++ + ++++  ++
+A +    +   B    +    +  ++
+  ++++ + ++++++ + ++++  ++
+ A    C              A   ++
+++++++++++++++++++++++++++
#end
