#domain
hospital
#levelname
LoveLock
#colors
blue: 0, A
orange: 5, F
red: 1, B
pink: 6, G
grey: 7, H
green: 2, C
brown: 9, J
cyan: 3, D
lightblue: 8, I
purple: 4, E
#initial
+++++++++++++++++++++++++++++++++++++
+ 0    9           5  F             +
+    ++++ +   +++      +++      +++ +
+    + B        +      + G  H     + +
+ 1  +    2+ JC +  6   +    7     + +
+    ++++++++++++      ++++++++++++ +
+                 G                 +
+++++++++  ++     +++++++++  +      +
+                 H                 +
+  +    ++ ++  +   +  ++++    +++++ +
+ 3+   +D +  +  + +   +  I      A + +
+  +   +  E  +  + +   ++++        + +
+  +   ++   +   + +   +  8      +++ +
+ 4+++           +    ++++          +
+++++++++++++++++++++++++++++++++++++
#goal
+++++++++++++++++++++++++++++++++++++
+   F                               +
+    ++++ +   +++      +++      +++ +
+    +          +      +          + +
+    +     +    +      +       E  + +
+    ++++++++++++      ++++++++++++ +
+  A       C                H    D  +
+++++++++  ++     +++++++++  +      +
+                      G       I    +
+  +    ++ ++  +   +  ++++    +++++ +
+  +   +  +  +  + +   +           + +
+  +   +     +  + +   ++++        + +
+  +   ++   +   + +   +         +++ +
+  +++    B      +    ++++  J       +
+++++++++++++++++++++++++++++++++++++
#end
