#domain
hospital
#levelname
MAceship
#colors
red: 1,D
cyan: 2,C
blue: 0,B,A
#initial
+++++++++
++++ ++++
++++ ++++
+++ 1 +++
+++2 0+++
+++   +++
+++   +++
++++ ++++
++++ ++++
+D     C+
+B+++++A+
+++++++++
#goal
+++++++++
++++A++++
++++B++++
+++D C+++
+++   +++
+++   +++
+++   +++
++++ ++++
++++ ++++
+       +
+ +++++ +
+++++++++
#end