#domain
hospital
#levelname
MAface
#colors
red: A,B,C,D,E,F,H,K,L,M,S,T,V,X,Y,Z,0
blue: 2,8
green: N,P,7,9,W
brown: 3,G
purple: 6
orange: I,O,U,5
cyan: 1,R
pink: Q,4
#initial
+++++++++++++++++++++++++++++++++++++++++++++++
+                 +++  +        +    ++++++++++
+  A    B     C      D +      E ++   ++  + + ++
+                      +         +   +   ++  ++
+                +++   +      ++++   +    + + +
+    F      H          +      +      +        +
+                      +++    +   K  +        +
+       2                       8    +        +
+                   +++              +        +
+     N                              +        +
+   L          M         S       T   +        +
+                              3     +  M     +
++                          ++++++++++        +
++       ++++          ++++          +        +
+  V                              X  +        +
+          ++++       ++++           +    M   +
+          +6 +       +  +           +        +
+          ++++       ++++          ++        +
+    Y                        Z     ++        +
+                 +               I  +      M +
+                                    +        +
+   VVV                              +        +
+   V+V    ++++++++++++++++          ++++++ +++
+   V+V    +1  P        7 +   +++++  +        +
+   V+V    +              +   +G G+  +        +
+ +++++++  +  G OU      R +   +   +  +        +
+   V+V    +              +     Q ++ +        +
+   V+V    +V++++++++++++++        + +        +
+   V+V    +++                +G G++ +    +   +
+   VVV                      ++   +  +        +
+         +++                 +++++  +        +
+    A         B          C          +     +  +
+            +G             +  +     +     V  +
+            +G                      +     V  +
+         4  +GGG   D        ++      +    VV  +
+V           +GGGG          +  5     + +   ++ +
+V          + GGG       +++          + +   +  +
+V        E + GGG                    + +     ++
+V        V +++++  9                 + +     ++
+V        V                          + VV  VV +
+V        V                          +        +
+V   W    V                          +        +
+VVVVVVVVVV                          +        +
+V        V                   ++++++++        +
++++++++++++++++++++++++++++++++++++++        +
+                                             +
+  ++ VVV                                  +  +
+ ++  V0                                    + +
+     VVV                                     +
+++++++++++++++++++++++++++++++++++++++++++++++
#goal
+++++++++++++++++++++++++++++++++++++++++++++++
+                 +++  +        +    ++++++++++
+                      +        ++   ++  + + ++
+                      + W I N   +   +   ++  ++
+                +++   +      ++++   +    + + +
+                      +      +      +        +
+                      +++    +      +        +
+                                    +        +
+                   +++              +        +
+                                    +        +
+                                    +        +
+                                    +        +
++                          ++++++++++        +
++       ++++          ++++          +        +
+                                    +        +
+          ++++       ++++           +        +
+          + 6+       +  +           +        +
+          ++++       ++++          ++        +
+                                   ++        +
+                 +                  +        +
+                                    +        +
+                                    +        +
+    +     ++++++++++++++++          ++++++ +++
+    +     +              +   +++++  +        +
+    +     +              +   +   +  +        +
+ +++++++  +  GROUP17     +   +   +  +        +
+    +     +              +       ++ +        +
+    +     + ++++++++++++++        + +        +
+    +     +++                +   ++ +    +   +
+                            ++   +  +        +
+         +++                 +++++  +        +
+                                    +     +  +
+            +              +  +     +        +
+      Q     +                       +        +
+            +               ++      +        +
+            +              +        + +   ++ +
+           +           +++          + +   +  +
+           +                        + +     ++
+           +++++                    + +     ++
+                           2        +        +
+                                    +        +
+                                    +        +
+                                    +        +
+                             ++++++++        +
++++++++++++++++++++++++++++++++++++++        +
+                                             +
+  ++                 M                    +  +
+ ++               M      M                 + +
+                                             +
+++++++++++++++++++++++++++++++++++++++++++++++
#end