#domain
hospital
#levelname
MAgic
#colors
orange: 0, A
purple: 1, B
cyan: 2, C
green: 3, D
#initial
++++++++++++++++++++++++++++++++
+  ++++++++D           ++      +
+ +        ++            +     +
++    0      +            +    +
+             +         1 +    +
+             +           +    +
+              +          +    +
+              +          +    +
+     +    +   +          +    +
+    +    +B+  +         +     +
+    + +  +   +         ++     +
+   +  +   +++         ++A     +
+   +  +              ++       +
+   +  +   +         ++        +
+  +    +   +++++++++          +
+  +    ++                     +
+  +     ++                    +
+   +     +++           2      +
+   +  3    +++          +++   +
+ C  +         ++++++++++      +
+     +                        +
++++++++++++++++++++++++++++++++
#goal
++++++++++++++++++++++++++++++++
+  ++++++++            ++      +
+ +  C     ++            +     +
++           +         A  +    +
+             +           +    +
+             +           +    +
+              +          +    +
+              +          +    +
+     +01  +   +          +    +
+    + 23 + +  +         +     +
+    + +  +   +         ++     +
+   +  +   +++         ++      +
+   +  +              ++       +
+   +  +   +         ++        +
+  +    +   +++++++++          +
+  +    ++                     +
+  +     ++              D     +
+   +     +++                  +
+   +       +++          +++   +
+    +  B      ++++++++++      +
+     +                        +
++++++++++++++++++++++++++++++++
#end