#domain
hospital
#levelname
makeMAga
#colors
orange: A,4,V,0
blue: 1,P,C
red: B
brown: E,J,L,H,2,3
grey: G,5
#initial
++++++++++++++++++++++++++++++++++++++++++++++++++
+                                                +
+                                                +
+                        AAA                     +
+                        AAA                     +
+     A     A            AAAA                    +
+     AAAAAAA            AAAA                    +
+    AA+AAA+AA           AAAA1                   +
+     AAAAAAA           PBAAPPP                  +
+     AAAAAAA          PBPPPPPP                  +
+      A4AAA           PBPPPPPP                  +
+    ++CBBBC++         PBPPPPPP                  +
+   +++CCBCC+++        PBPPPPAA                  +
+  +++++CBC+++++        PPPPPP                   +
+  +++++CBC+++++         PPPPP                   +
+                        PPPPP                   +
+                        EEEEE                   +
+                       EEEEEE                   +
+                                                +
++++++++++++++++++++++++++++++++++++ +++++++++++++
+                              +   + +           +
+                              + + + +           +
+                              + + + +           +
+          +++++               + + + +           +
+         +GGGGG++++           + + + +           +
+        +GGGGG5    +          + + + +           +
+        +GGGG+     +          + + + +           +
+        +GGGGGG  + +          + + + +           +
+        +GGGGGG++ +           + + + +           +
+        ++GGGG+               + +   +           +
+       +JJ+GJG+               + +++++           +
+      +JJJJ+JJJ+                   ++           +
+      +JJJJJ+JJ+                   ++           +
+      +JJJJJ+JJ+                    +           +
+      +JJJJJ+JJ+           +        +           +
+     +JJJJJJ+JJ+          +++       ++          +
+     +JJJJJ+JJJ+         +LLL+       ++         +
+     +JJJJJ+JJ+         +LLLLL+       +++       +
+    +JJJJJ+JJJ+         ++LLL++         +       +
+    +JJJJJ+JJ+        ++LLLLLLL++       ++      +
+    +JJJJ+JJ+        +LLLLLLLLLLL+       ++     +
+   ++JJJ+JJ+        +LLLLLLLLLLLLL+       ++    +
+  +J+JJJ+JJ+        ++L++LLLLL++L++        +++  +
+ +JJ+JJ+ +V+       +LL++ +HHH++ +LL+         ++ +
+ +J++JJ+ +V++      +LL++++HHH++++LL+          +++
+ ++ +J+ +VVVV+     +LLL++HHHHH++LLL+            +
+    +J+  ++++V+     ++HHHHHHHHHHH++             +
+     +       +        +++++2+++++               +
+                           3                   0+
++++++++++++++++++++++++++++++++++++++++++++++++++
#goal
++++++++++++++++++++++++++++++++++++++++++++++++++
+                                                +
+     AAAAAA           PPPPPP                    +
+   AAAAAAAAA               PP                   +
+    AAAAAAAA               PP                   +
+    A AAAAA A               P                   +
+    A       A                                   +
+      +   +                                     +
+                                                +
+                                                +
+                                                +
+    ++     ++                                   +
+   +++     +++                                  +
+  +++++   +++++                                 +
+  +++++   +++++                                 +
+                                                +
+                                                +
+                                                +
+                                                +
++++++++++++++++++++++++++++++++++++ +++++++++++++
+                              +   + +           +
+                              + + + +           +
+                              + + + +           +
+          +++++               + + + +           +
+         +     ++++           + + + +           +
+        +          +          + + + +           +
+        +    +     +          + + + +           +
+        +        + +          + + + +           +
+        +      ++ +           + + + +           +
+        ++    +               + +   +           +
+       +  +   +               + +++++           +
+      +    +   +                   ++           +
+      +     +  +                   ++           +
+      +     +  +                    +           +
+      +     +  +           +        +           +
+     +      +  +          +++       ++          +
+     +     +   +         +   +       ++         +
+     +     +  +         +     +       +++       +
+    +     +   +         ++   ++         +       +
+    +     +  +        ++       ++       ++      +
+    +    +  +        +           +       ++     +
+   ++   +  +        +             +       ++    +
+  + +   +  +        ++ ++     ++ ++        +++  +
+ +  +  + + +       +  ++ +   ++ +  +         ++ +
+ + ++  + + ++      +  ++++   ++++  +          +++
+ ++ + + +    +     +   ++     ++   +            +
+    + +  ++++ +     ++           ++             +
+     +       +        +++++ +++++               +
+                                                +
++++++++++++++++++++++++++++++++++++++++++++++++++
#end