#domain
hospital
#levelname
MAmaMASS
#colors
red: 0, A, B, C, D
orange: 1
#initial
++++++++++
++++++++ +
+  ++++  +
+  +++   +
+  ++  A +
+ ++++ B +
+  +++  ++
+ C 0   D+
+ 1    +++
++++++++++
#goal
++++++++++
++++++++ +
+  ++++  +
+  +++ C +
+  ++    +
+ ++++   +
+ A+++  ++
+B       +
+    D1+++
++++++++++
#end