#domain
hospital
#levelname
MArachnid
#colors
blue: 0,1,2,5,6,7,8,9
green: 3
red: 4
#initial
++++++++++++++++++++++++++++++++++++++++++++++++++
+              +                                 +
+             + +     ++++                       +
+            +1 +    +2   +  ++++                +
+           +  +    +  +++  + 3  +               +
+          +  +    +  +    +  +++                +
+         +  +    +  +   ++  +    +++++          +
+         +  +   +  +   +   +    + 4   +         +
+         +  +  +  +   +   +    +  ++++          +
+        +  +  +  +   +   +    +  +              +
+       +  +  +   +++++  +    +  +               +
+      +  +  ++++     +  ++  +  +                +
+     +   +++            +   +  ++               +
+     ++                  +++     +  +++         +
+    +                             ++   +++      +
+    +                              5   ++++     +
+    +             0                   +         +
+    +                              6   ++++     +
+    +                             ++   +++      +
+     ++                   +++     + +++         +
+     +   +++             +   +  ++              +
+      +  +  ++++     +  ++    +  +              +
+       +  +   +  +++++  +      +  +             +
+        +  +   +  +  +   +      +  +            +
+         +  +   +  +  +   +      +  ++++        +
+         +  +    +  +  +  8+      +   7 +       +
+         +  +     +  +  ++  +      +++++        +
+          +  +     +  +   +  ++++               +
+           +  +     +  ++  +     +              +
+            + +     +  9+   +++++               +
+             + +     ++++                       +
+              +                                 +
+                                                +
++++++++++++++++++++++++++++++++++++++++++++++++++
#goal
++++++++++++++++++++++++++++++++++++++++++++++++++
+              +                                 +
+             + +     ++++                       +
+            +9 +    +5   +  ++++                +
+           +  +    +  +++  + 7  +               +
+          +  +    +  +    +  +++                +
+         +  +    +  +   ++  +    +++++          +
+         +  +   +  +   +   +    + 6   +         +
+         +  +  +  +   +   +    +  ++++          +
+        +  +  +  +   +   +    +  +              +
+       +  +  +   +++++  +    +  +               +
+      +  +  ++++     +  ++  +  +                +
+     +   +++            +   +  ++               +
+     ++                  +++     +  +++         +
+    +                             ++   +++      +
+    +                              4   ++++     +
+    +                                 +         +
+    +                              3   ++++     +
+    +                             ++   +++      +
+     ++                   +++     + +++         +
+     +   +++             +   +  ++              +
+      +  +  ++++     +  ++    +  +              +
+       +  +   +  +++++  +      +  +             +
+        +  +   +  +  +   +      +  +            +
+         +  +   +  +  +   +      +  ++++        +
+         +  +    +  +  +   +      +     +       +
+         +  +     +  +  ++  +      +++++        +
+          +  +     +  +   +  ++++               +
+           +  +     +  ++  +   1 +              +
+            +2+     +  0+   +++++               +
+             + +     ++++                       +
+              +                                 +
+                                                +
++++++++++++++++++++++++++++++++++++++++++++++++++
#end