#domain
hospital
#levelname
MASstroke
#colors
purple: C,1
pink: 0,B
red: F,3
green: D,2
#initial
++++++++++++++++++++++++++++++
+++           ++        C+++++
+++++ ++ + +  ++ +++ +  ++++++
+ ++++++ ++++ ++ + +++++++++++
+ + +++++++0+ ++ +  ++     +++
+    ++                  + +++
++   +++ +    ++++++++++ +  F+
+ ++ + ++++++ ++++++      + ++
+  + + +      +3++++  ++ ++  +
+    +   ++   + +        ++ ++
+++  +++++++  + +  + +       +
+    + ++++++ + +  + +       +
+B++              ++1+ + + + +
+++++ +  ++++ ++  ++++++ +++ +
++++  +  + ++ +++ +++++   + ++
++++ +  ++ +++++  +++++      +
++++ ++     ++    ++  ++ + +++
+++++ + ++ +++ ++ +  ++  + +++
+++ + +  +++++++  ++  +  ++D++
++                           +
+++ +++++ ++ ++ ++++ +++++ +++
+++ + + +  ++     +  + + + +++
+++         ++ ++++        +++
+++  +++++ ++    +  +++++  +++
+    ++++  +  +  ++     +   ++
+  + +++++2++ +++++++ + + ++++
++++++++++++++++++++++++++++++
#goal
++++++++++++++++++++++++++++++
+++           ++         +++++
+++++ ++ + +  ++ +++ +  ++++++
+B++++++ ++++ ++ + +++++++++++
+ + +++++++ + ++ +  ++     +++
+    ++                  + +++
++   +++ +    ++++++++++ +   +
+ ++ + ++++++ ++++++      + ++
+  + + +      + ++++  ++ ++  +
+    +   ++   + +        ++ ++
+++  +++++++  + +  + +       +
+    + ++++++C+ +  + +       +
+ ++              ++ + + + + +
+++++ +  ++++ ++  ++++++ +++ +
++++  +  + ++ +++ +++++   + ++
++++ +  ++ +++++  +++++      +
++++ ++     ++    ++  ++ + +++
+++++ + ++ +++F++ +  ++  + +++
+++ + +  +++++++  ++  +  ++ ++
++       0  1  2  3          +
+++ +++++ ++ ++ ++++ +++++ +++
+++ + + +  ++     +  + + + +++
+++         ++ ++++        +++
+++  +++++ ++    +  +++++  +++
+    ++++  +  +  ++     +   ++
+D + +++++ ++ +++++++ + + ++++
++++++++++++++++++++++++++++++
#end