#domain
hospital
#levelname
MAvis
#colors
red: 0, A
blue: 1, B
green: 2, C
orange: 3, D
#initial
+++++++++++++++++
+0A     +     B1+
+       +       +
+       +       +
+       +       +
+               +
+       +       +
+       +       +
+2C     +     D3+
+++++++++++++++++
#goal
+++++++++++++++++
+ D     +     A +
+       +       +
+       +       +
+       +       +
+               +
+       +       +
+       +       +
+ B     +     C +
+++++++++++++++++
#end
