#domain
hospital
#levelname
MazeRun
#colors
blue: 0,D
red: 1,T
green: 2,U,K
#initial
++++++++++++++++++++++++++++++++++++++
++++++++DTU+++++++++++++++++++++++++++
++++++++   +++++++++++++++++++++++++++
++++++++   +++++++++++++++++++++++++++
++++++++   +++++++++++++++++++++++++++
++++++++   +++++++++++++++++++++++++++
++++++++   +++++++++++++++++++++++++++
+0                                   +
+1                                   +  
+2                                   +
++++++++   +++++++++++++++++++++++++++
++++++++   +++++++++++++++++++++++++++
++++++++   +++++++++++++++++++++++++++
++++++++   +++++++++++++++++++++++++++
++++++++   +++++++++++++++++++++++++++
++++++++ DK+++++++++++++++++++++++++++
++++++++++++++++++++++++++++++++++++++
#goal
++++++++++++++++++++++++++++++++++++++
++++++++   +++++++++++++++++++++++++++
++++++++   +++++++++++++++++++++++++++
++++++++   +++++++++++++++++++++++++++
++++++++   +++++++++++++++++++++++++++
++++++++   +++++++++++++++++++++++++++
++++++++   +++++++++++++++++++++++++++
+                                 DTU+
+       012                          +  
+                                  DK+
++++++++   +++++++++++++++++++++++++++
++++++++   +++++++++++++++++++++++++++
++++++++   +++++++++++++++++++++++++++
++++++++   +++++++++++++++++++++++++++
++++++++   +++++++++++++++++++++++++++
++++++++   +++++++++++++++++++++++++++
++++++++++++++++++++++++++++++++++++++
#end