#domain
hospital
#levelname
MAze
#colors
red: B,1
lightblue: 9
green: C,2
cyan: D,3
purple: E,4
brown: I,8
orange: F,5
grey: H,7
pink: G,6
blue: 0,A
#initial
+++++++++++++++++++++++++++++++++++++++++++++ 
++ +           +           +                + 
++ +  ++   ++  +++++++++++ ++++++++ +++++++++ 
++ + ++++ ++++ +           +        +++++++++ 
++ + +++++++++ +++++++++++ ++++++++ +++++++ + 
++ +  +++++++  +  B        +             9+ + 
++ +    +++    +++++++++++ ++++++++ +++++++ + 
+        +                                   +
+   C      +++++++++++++++ + ++++++ + +++++ + 
+ ++++++ +               + +      + + +++++ + 
+ +      + +     D       + + +    + + +++++ + 
+ +      + +++++++++++++++ + ++++++ + +++++ + 
+ ++++++++       E         +                + 
+          +++++++++++++++ +++++ ++ + +++++ + 
+ ++++++++ +++++++++++++++ +      + + +++++ + 
+ ++++++++ +++++++++++++++ +      + + +++++ + 
+ ++++++++I      F         +      + + +++++ + 
+ ++++++++ +++++++++++++++ ++++++++ + +++++ + 
+          +                    H   +       + 
+ ++++++++ +      G      + ++++++++ +++++++ + 
+  0 1 2 + +++++++++++++++ ++++++++ +       + 
+  3 4 5   D C A B A D     ++++++++ +       + 
+  6 7 8I                  ++++++++ +       + 
+++++++++++++++++++++++++++++++++++++++++++++ 
#goal
+++++++++++++++++++++++++++++++++++++++++++++ 
++A+           +           +              IF+ 
++C+  ++   ++  +++++++++++ ++++++++ +++++++++ 
++A+ ++++ ++++ +           +9       +++++++++ 
++D+ +++++++++ +++++++++++ ++++++++ +++++++ + 
++B+  +++++++  +           +            D + + 
++D+    +++    +++++++++++ ++++++++ +++++++ + 
+        +                                   +
+          +++++++++++++++ + ++++++ + +++++ + 
+ ++++++ +               + +      + + +++++ + 
+ +  C   + +             + + + E  + + +++++ + 
+ +      + +++++++++++++++ + ++++++ + +++++ + 
+ ++++++++                 +                + 
+          +++++++++++++++ +++++ ++ + +++++ + 
+ ++++++++ +++++++++++++++ +      + + +++++ + 
+ ++++++++ +++++++++++++++ +  B   + + +++++ + 
+ ++++++++                 +      + + +++++ + 
+ ++++++++ +++++++++++++++ ++++++++ + +++++ + 
+          +                        +       + 
+ ++++++++ +      G      + ++++++++ +++++++ + 
+  0 1 2 + +++++++++++++++ ++++++++ +       + 
+  3 4 5                   ++++++++ +   H   + 
+  6 7 8 I                 ++++++++ +       + 
+++++++++++++++++++++++++++++++++++++++++++++ 
#end