#domain
hospital
#levelname
moveMAcat
#colors
red: 0,1,A
blue: 2,3,B
green: 4,5,C
cyan: 6,7,D
brown: X,8
orange: 9,E
#initial
++++++++++++++++++++++++++++++++++++++++++++
+8                                         +
+   1 A                              3 B   +
+   + +                              + +   +
+   + +             9                + +   +
+   + +                              + +   +
+   + +                              + +   +
+   XXXXXXXXXXXXXXXXXXXXXXXXXXXXXXXXXXXX   +
+   X                                  X   +
+   X   0 A          E           2 B   X   +
+   X   + +                      + +   X   +
+   X   + +                      + +   X   +
+   X   + +                      + +   X   +
+   X   + +                      + +   X   +
+   X   + +                      + +   X   +
+   X                                  X   +
+ ++X+++++++++++++        ++++++++++   X++ +
+   X   +                          +   X   +
+++ X   +        ++++++++++        +   X +++
+   X   +        +        +        +   X   +
+ ++X   +        +        +        +   X++ +
+   X   +        ++++++++++        +   X   +
+++ X   +                          +   X +++
+   X   ++++++++++        +++++++++++++X   +
+ ++X                                  X++ +
+   X   + +                      + +   X   +
+++ X   + +                      + +   X +++
+   X   + +                      + +   X   +
+ ++X   + +                      + +   X++ +
+   X   + +                      + +   X   +
+   X   4 C                      6 D   X   +
+   X                                  X   +
+   XXXXXXXXXXXXXXXXXXXXXXXXXXXXXXXXXXXX   +
+   + +                              + +   +
+   + +                              + +   +
+   + +                              + +   +
+   + +                              + +   +
+   + +                              + +   +
+   5 C                              7 D   +
+                                          +
++++++++++++++++++++++++++++++++++++++++++++
#goal
++++++++++++++++++++++++++++++++++++++++++++
+8                       9                 +
+   C 1                              D 3   +
+   + +                              + +   +
+   + +                              + +   +
+   + +                              + +   +
+   + +                              + +   +
+   X XXXXXXXXXXXXXXXXXXXXXXXXXXXXXXXXXX   +
+   X                                  X   +
+   X   C                        D     X   +
+   X   + +                      + +   X   +
+   X   + +                      + +   X   +
+   X   + +                      + +   X   +
+   X   + +                      + +   X   +
+   X   + +                      + +   X   +
+   X                                  X   +
+ ++X+++++++++++++        ++++++++++   X++ +
+   X   +2                        4+   X   +
+++ X   +        ++++++++++        +   X +++
+   X   +        +        +        +   X   +
+ ++X   +        +        +        +   X++ +
+   X   +        ++++++++++        +   X   +
+++ X   +6                        0+   X +++
+   X   ++++++++++        +++++++++++++X   +
+ ++X                                  X++ +
+   X   + +                      + +   X   +
+++ X   + +                      + +   X +++
+   X   + +           E          + +   X   +
+ ++X   + +                      + +   X++ +
+   X   + +                      + +   X   +
+   X   A                        B     X   +
+   X                                  X   +
+   XXXXXXXXXXXXXXXXXXXXXXXXXXXXXXXXXXXX   +
+   + +                              + +   +
+   + +                          X   + +   +
+   + +                              + +   +
+   + +                              + +   +
+   + +                              + +   +
+   A 5                              B 7   +
+                                          +
++++++++++++++++++++++++++++++++++++++++++++
#end
