#domain
hospital
#levelname
NineChars
#colors
blue: A,0,C
pink: E,2
red: B,D,1
#initial
+++++++++++++
+A       E  +
+      ++++++
+           +
+++ +++ +++++
+B+ + +    D+
+ + + +     +
+ +2+ +0 ++++
+ +++ +  ++++
+      C   1+
+++++++++++++
#goal
+++++++++++++
+       E  D+
+      ++++++
+         AC+
+++ +++ +++++
+ + +B+     +
+ + + +     +
+ + + +  ++++
+ +++ +  ++++
+           +
+++++++++++++
#end