#domain
hospital
#levelname
OlsenBand
#colors
red: 0, 1, B
green: 2, 3, M
blue: 4, S
orange: 5, X
#initial
++++++++++++++++++++++++++++++
+           +    +           +
+  0     S  +    +       2   +
+    B  +   +    +  M +      +
+5X                  S       +
+                      M     +
+  +   B    +    +       4   +
+           +    + +         +
+        X  +    +           +
+           +    +           +
+++++++++++++    +++++++++++++
+++++++++++++++ ++++++++++++++
+++++++++++++++ ++++++++++++++
+++++++++++++++ ++++++++++++++
+++++++++++++++ ++++++++++++++
+++++++++++++++ ++++++++++++++
+++++++++++++++ ++++++++++++++
+++++++++++++++ ++++++++++++++
+           +    +           +
+   + M     +    +  B     +  +
+           +    +           +
+                            +
+  3                      1  +
+    +  M   +    + +         +
+   S       +    +     B     +
+           +    +           +
+           +    +           +
++++++++++++++++++++++++++++++
#goal
++++++++++++++++++++++++++++++
+           +    +           +
+           +    +           +
+  S    + M +    +    +   S B+
+                            +
+                  B         +
+  +        +    +           +
+           +    + +         +
+  M        +    +           +
+           +    +           +
+++++++++++++    +++++++++++++
+++++++++++++++ ++++++++++++++
+++++++++++++++ ++++++++++++++
+++++++++++++++ ++++++++++++++
+++++++++++++++ ++++++++++++++
+++++++++++++++ ++++++++++++++
+++++++++++++++ ++++++++++++++
+++++++++++++++ ++++++++++++++
+           +    +           +
+  B+       +    +        + M+
+           +    +           +
+                            +
+                     X      +
+    +      +    + +         +
+         B +    + M      SX +
+           +    +           +
+           +    +           +
++++++++++++++++++++++++++++++
#end
