#domain
hospital
#levelname
OPN
#colors
blue: 0,A
orange: 5,F
red: 1,B
pink: 6,G
cyan: 2,C
grey: H,7
purple: 3,D
lightblue: 8,I
green: 4,E
brown: J,9
#initial
+++++++++++++++++++++++++++
+0  AA A    5+FA  A  A    +
+      A                  +
+++++++++++++++++++++++++++
+1         B +6    A    G +
+   A        +  AA        +
+++++++++++++++++++++++++++
+         2C +          H7+
+                         +
+++++++++++++++++++++++++++
+         3A  8    I  A   +
+       D                 +
+++++++++++++++++++++++++++
+4E    EE    +J         +9+
+   EE    EEE+++++ ++++   +
+++++++++++++++++++++++++++
#goal
+++++++++++++++++++++++++++
+           A+            +
+                        F+
+++++++++++++++++++++++++++
+           B+           G+
+            +            +
+++++++++++++++++++++++++++
+           H+ C          +
+                         +
+++++++++++++++++++++++++++
+           I            D+
+ 3                       +
+++++++++++++++++++++++++++
+           E+          +J+
+            +++++9++++   +
+++++++++++++++++++++++++++
#end