#domain
hospital
#levelname
PinWheel
#colors
red: 0,A,B,C,D,E,F
blue: 1,G,H,I,J,K,L
green: 2,M,N,O,P,Q,R
orange: 3,S,T,U,V,W,X
#initial
+++++++++++++++++++++++++++++++++++++++++++
+++++++++++++++++++++++++++++++++++++++++++
+++++++++++++++++++++++++++++++++++++++++++
++      G     +++++++++++++++     M      ++
+++++++++++++ +++++++++++++++ +++++++++++++
+++++++++++++ +++++++++++++++ +++++++++++++
++++++++++       +++++++++       ++++++++++
++++++++++       +++++++++       ++++++++++
++++++++++       +++++++++       ++++++++++
+++++++++++++ +++++++++++++++ +++++++++++++
+++++++++++++ 3      +      2 +++++++++++++
++++++++++++++ T U V   N O P ++++++++++++++
++++++++++++++ W X   + Q R   ++++++++++++++
++++++++++++++ ++ +++++++ ++ ++++++++++++++
++++++++++++++ K L   + E F   ++++++++++++++
++++++++++++++ H I J   B C D ++++++++++++++
+++++++++++++ 1      +      0 +++++++++++++
+++++++++++++ +++++++++++++++ +++++++++++++
++++++++++       +++++++++       ++++++++++
++++++++++       +++++++++       ++++++++++
++++++++++       +++++++++       ++++++++++
+++++++++++++ +++++++++++++++ +++++++++++++
+++++++++++++ +++++++++++++++ +++++++++++++
++      S     +++++++++++++++     A      ++
+++++++++++++++++++++++++++++++++++++++++++
+++++++++++++++++++++++++++++++++++++++++++
+++++++++++++++++++++++++++++++++++++++++++
#goal
+++++++++++++++++++++++++++++++++++++++++++
+++++++++++++++++++++++++++++++++++++++++++
+++++++++++++++++++++++++++++++++++++++++++
++ABCDEF      +++++++++++++++      GHIJKL++
+++++++++++++ +++++++++++++++ +++++++++++++
+++++++++++++ +++++++++++++++ +++++++++++++
++++++++++       +++++++++       ++++++++++
++++++++++       +++++++++       ++++++++++
++++++++++       +++++++++       ++++++++++
+++++++++++++ +++++++++++++++ +++++++++++++
+++++++++++++        +        +++++++++++++
++++++++++++++               ++++++++++++++
++++++++++++++       +       ++++++++++++++
++++++++++++++ ++ +++++++ ++ ++++++++++++++
++++++++++++++       +       ++++++++++++++
++++++++++++++               ++++++++++++++
+++++++++++++        +        +++++++++++++
+++++++++++++ +++++++++++++++ +++++++++++++
++++++++++       +++++++++       ++++++++++
++++++++++       +++++++++       ++++++++++
++++++++++       +++++++++       ++++++++++
+++++++++++++ +++++++++++++++ +++++++++++++
+++++++++++++ +++++++++++++++ +++++++++++++
++MNOPQR      +++++++++++++++      STUVWX++
+++++++++++++++++++++++++++++++++++++++++++
+++++++++++++++++++++++++++++++++++++++++++
+++++++++++++++++++++++++++++++++++++++++++
#end
