#domain
hospital
#levelname
PJMAS
#colors
blue: 1,M
red: 2,P
purple: 3,J
cyan: 4,A
pink:0,S,T
#initial
++++++++++++++++++++
+ M   A    +      J+
+                  +
++++    +    3 +   +
+  0   ++      ++  +
+P    +        +   +
+    +             +
+                 T+
++               + +
+J              +  +
+   2     4     +  +
+ +                +
+  +        S      +
+   +       1  ++  +
+      +           +
+A   M +       P   +
++++++++++++++++++++
#goal
++++++++++++++++++++
+          +       +
+                  +
++++    +      +   +
+      ++      ++  +
+     +        +   +
+    +             +
+         P        +
++               + +
+        JMA    +  +
+      P     S  +  +
+ +      M J       +
+  +     T A       +
+   +          ++  +
+      +           +
+      +           +
++++++++++++++++++++
#end