#domain
hospital
#levelname
ProjectD
#colors
grey: 0, M, E, F
red: 1, A
green: 2, B
blue: 3, C
cyan: 4, G
orange: 6, N
pink: 5, H
purple: 7, O
lightblue: 8, P
brown: 9, D
#initial
++++++++++++++++++++++++++++++++++++++++++++++++++
+0              +1                              2+
+  ++           +                                +
+  ++           +          ++++++++++++          +
+  ++           +        +              +        +
+               +             B    B             +
++++++++ ++++++++        + ++++++++++++ +        +
+               +        +   ++    ++   +        +
++++++++ ++++++++  +++++++   ++    ++   +++++++  +
+EFFE           +  +     +              +     +  +
++++++++ ++++++++  +     +     ACCA     +     +  +
+MEM            +  +     +A++++++++++++ +     +  +
++++++++ ++++++++  +       +    BB    +       +  +
+MMM            +  +       + + ++++ + +       +  +
++++++++ ++++++++  +AA     + + +  + + +     CC+  +
+               +  +AA       +      +       CC+ 3+
++++++++++++++++++++++++++++++++++++++++++++++++++
+    +NN   +NN       +             +   OO+   OO+ +
+ +  +  +  +NN+      +             +  +  +  +  + +
+N+  +  +  +  +      +             +  +  +  +  + +
+N+  +  +  +  +      +             +  +  +  +  + +
+N+  +  +  +  +  +++++   ++++++    +  +  +  +  + +
+ +  +  +  +  +  ++++++  +++++++   +  +  +  +  + +
+ +  +  +  +  +  ++ P ++ ++ D +++  +  +  +  +  + +
+ +  +  +  +  +  ++   ++ ++    ++  +  +  +  +  + +
+ +  +  +  +  +  ++ NO++ ++ NO ++  +  +  +  +  + +
+ +  +  +  +  +  ++++++  ++    ++  +  +  +  +  + +
+ +  +  +  +  +  +++++   ++    ++  +  +  +  +  +O+
+ +  +  +  +  +  ++ 6+7  ++   +++  +  +  +  +  +O+
+ +  +  +  +  +  ++  +   +++++++   +  +  +  +  +O+
+ +  +  +NN+  +  ++NN+OO ++++++    +OO+  +  +  + +
+ +NN   +     +  NNNN+OOOOOOO       OO+   OO+    +
++++++++++++++++++++++++++++++++++++++++++++++++++
+       5  G   G   G   G   G  ++ ++    ++ +++++ ++
+H+ + + + + + + + + + + + + + ++ ++ ++++   ++++ ++
+H                            ++ ++ +++ 8DP +++ ++
+H+ + + + + + + + + + + + + + ++ ++ ++++   ++++ ++
+H                            ++ ++ +++++ +++++ ++
+H+ + + + + + + + + + + + + + ++ ++ +++++ +++++ ++
+H                            ++ ++ ++++      + ++
+ + + + + + + + + + + + + + +    ++      ++++   ++
+G                            ++ ++ ++++      + ++
+G+ + + + + + + + + + + + + + ++ ++ +++++ +++++ ++
+G                            ++ ++ +++++ +++++ ++
+G+ + + + + + + + + + + + + + ++ ++ ++++   ++++ ++
+G                            ++ ++ +++ DP9 +++ ++
+G+ + + + + + + + + + + + + + ++ ++ ++++   ++++ ++
+       4  H   H   H   H   H  ++ ++ +++++ ++    ++
++++++++++++++++++++++++++++++++++++++++++++++++++
#goal
++++++++++++++++++++++++++++++++++++++++++++++++++
+               +                                +
+  ++           +                                +
+  ++           +          ++++++++++++          +
+  ++           +        +              +        +
+               +               AA               +
++++++++ ++++++++        + ++++++++++++ +        +
+               +        +   ++    ++   +        +
++++++++ ++++++++  +++++++   ++ BB ++   +++++++  +
+            MEM+  +     +              +     +  +
++++++++ ++++++++  +     +              +     +  +
+            EMF+  +     + ++++++++++++ +     +  +
++++++++ ++++++++  +       +          +       +  +
+           FMME+  +       + + ++++ + +       +  +
++++++++ ++++++++  +       + + +32+ + +       +  +
+              0+1A+         +      +         +CC+
++++++++++++++++++++++++++++++++++++++++++++++++++
+    +     +         +             +     +     +O+
+ +  +  +  +  +      +             +  +  +  +  +O+
+ +  +  +  +  +      +             +  +  +  +  +O+
+ +  +  +  +  +      +             +  +  +  +  + +
+ +  +  +  +  +  +++++   ++++++    +  +  +  +  + +
+ +  +  +  +  +  ++++++  +++++++   +  +  +  +  + +
+ +  +  +  +  +  ++   ++ ++   +++  +  +  +  +  + +
+ +  +  +  +  +  ++   ++ ++    ++  +  +  +  +  + +
+ +  +  +  +  +  ++   ++ ++    ++  +  +  +  +  + +
+ +  +  +  +  +  ++++++  ++    ++  +  +  +  +  + +
+ +  +  +  +  +  +++++   ++    ++  +  +  +  +  + +
+ +  +  +  +  +  ++  +   ++   +++  +  +  +  +  + +
+N+  +  +  +  +  ++  +   +++++++   +  +  +  +  + +
+N+  +  +  +  +  ++ 6+ 7 ++++++    +  +  +  +  + +
+N+     +     +      +                +     +    +
++++++++++++++++++++++++++++++++++++++++++++++++++
+                             ++H++   D++P+++++9++
+ + + + + + + + + + + + + + + ++ ++ ++++   ++++ ++
+                             ++H++ +++     +++ ++
+ + + + + + + + + + + + + + + ++ ++ ++++   ++++ ++
+                             ++H++ +++++ +++++ ++
+ + + + + + + + + + + + + + + ++ ++ +++++ +++++ ++
+                             ++5++ ++++      + ++
+ + + + + + + + + + + + + + +    ++      ++++   ++
+                             ++4++ ++++      + ++
+ + + + + + + + + + + + + + + ++ ++ +++++ +++++ ++
+                             ++G++ +++++ +++++ ++
+ + + + + + + + + + + + + + + ++ ++ ++++   ++++ ++
+                             ++G++ +++     +++ ++
+ + + + + + + + + + + + + + + ++ ++ ++++   ++++ ++
+                             ++G++8+++++D++P   ++
++++++++++++++++++++++++++++++++++++++++++++++++++
#end