#domain
hospital
#levelname
RaedFathi
#colors
red: 0, A
blue: 1
#initial
++++++++++++
+0A     ++++
++++++++++++
+1++++++++++
++++++++++++
#goal
++++++++++++
+     A ++++
++++++++++++
+ ++++++++++
++++++++++++
#end
