#domain
hospital
#levelname
SeisSiete
#colors
blue: 0,B,A,G,R,O,U,P
red: 1,2,S,E,I,X,V,N
#initial
+++++++++++++++
+0    1+2     +
+      +    S +
+  +++++++++  +
+  ++++++++E ++
+  ++++++++  ++
+SIX  B+++V +++
+      +++  +++
+  ++  ++E ++++
+  ++  ++  ++++
+      +N +++++
+A     +  +++++
+++++++++++++++
++GROUP+XXVIII+
+++++++++++++++
#goal
+++++++++++++++
+      +      +
+      +SEVEN +
+  +++++++++  +
+  ++++++++  ++
+  ++++++++  ++
+     A+++  +++
+      +++  +++
+  ++  ++  ++++
+  ++  ++  ++++
+      +  +++++
+B    0+  +++++
+++++++++++++++
++     +      +
+++++++++++++++
#end