#domain
hospital
#levelname
sublevels
#colors
orange: W,0
pink: N
blue: 1,F,7,9
lightblue: V
green: X,8,4,6
brown: C,5
purple: Z,A,3
cyan: M,2
red: L
#initial
++++++++++++++++++++++++++++++++++++++++++++++++++
+ W       W   W   NN+++++++  ++              NWWW+
+W  WWWWW   W   W 1N+++++++  N               NWWW+
+ W  W   WWWFWWW WNWFWFW 7+  N        W        WW+
+  W   W          NN+++++    N                NNN+
+NNNNNNNNNNNNNNNNNNFWFWF 0+  N                   +
+++++++++++++++++++++++++++  +++++++++++++++++++++
+ FFV XXC   X   Z   M + + +++ LM+ 8              +
+ FF VXXC   X C Z + 4M   + +  LM++++++++++++++++ +
+ FFVXXXC   X   Z + M + + + + LM+                +
+VVVVXXXC   X CCZ + M  + + +  LM+ ++++++++++++++++
+XXXXXXXC   X   Z + M + + + + LM+                +
+X6XXXX C   XCC Z + M  + + +  LM++++++++++++++++ +
+  XXXX C   X   Z + M + + + + LM+                +
+CCCCCCCC   X C Z + M  + + +  LM+ ++++++++++++++++
+           X   Z + M + + + + LM+                +
+           X CCZ + M  + + +  LM++++++++++++++++ +
+           X   ZX+ M + + + + LM+                +
+XXXXXXXXXXXXCC ZX+ M  + + +  LM+ ++++++++++++++++
+   C     C     ZX+ M + + + + LM+                +
+5C C C C C C C ZX+ M  + + +  LM++++++++++++++++ +
+     C     C   ZX+ M + + + + LM+                +
+ZZZZZZZZZZZZZZZZX+ M  + + +  LM+ ++++++++++++++++
+ XXXXXXXXXXXXXXXX+ M + + + + LM+                +
+++++++++++++++++++ M  + + +  LM++++++++++++++++ +
+                   M + + + + L +                +
+MMMMMMMMMMMMMMMMMMMM  + + +  L + ++++++++++++++++
+  AAA                + + + + L +                +
+ 3AAA                 + + +  L ++++++++++++++++ +
+  AAAA                 + + + L +                +
+  AAA                   + +  L + ++++++++++++++++
++ + + + + + + + + + + +  + + L +                +
+ + + + + + + + + + + + +  +  L ++++++++++++++++ +
++ + + + + + + + + + + + +  + L +                +
+ + + + + + + + + + + + + +   L + ++++++++++++++++
+                             L +                +
+LLLLLLLLLLLLLLLLLLLLLLLLLLLLLL ++++++++++++++++ +
+MMMMMMMMMMMMMMMMMM      2      +                +
+++++++++++++++++++++++++ +++++++ ++++++++++++++++
+ +             +  +  +     +   +                +
+  +     + +     + +   +   + +  ++++++++++++++++ +
+   +   +   +     ++    + +   + +                +
+    + +     +     +           ++ ++++++++++++++++
+     + +   + +   + +   +     +++                +
+    +   + +   +     + + +    + ++++++++++++++++ +
+   +     +     + ++      +   + +                +
+  +             +   +    ++ +  + ++++++++++++++++
+ +               + +       ++  + +   +   +    9 +
++                 +            +   +   + X      +
++++++++++++++++++++++++++++++++++++++++++++++++++
#goal
++++++++++++++++++++++++++++++++++++++++++++++++++
+                   +++++++FW++               W  +
+ F                 +++++++WF                 WWW+
+                         +FW                    +
+                1  +++++                        +
+                         +WF                    +
+++++++++++++++++++++++++++FW+++++++++++++++++++++
+    6        5       + + +++   +9               +
+                 +      + +    ++++++++++++++++ +
+                 +   + + + +   +                +
+                 +    + + +    + ++++++++++++++++
+                 +   + + + +   +                +
+                 +    + + +    ++++++++++++++++ +
+                 +   + + + +   +                +
+                 +    + + +    + ++++++++++++++++
+                 +   + + + +   +                +
+                 +    + + +    ++++++++++++++++ +
+                 +   + + + +   +                +
+                 +    + + +    + ++++++++++++++++
+                 +   + + + +   +                +
+                 +    + + +    ++++++++++++++++ +
+                 +   + + + +   +                +
+                 +X   + + +    + ++++++++++++++++
+4                +X  + + + +   +                +
+++++++++++++++++++X   + + +    ++++++++++++++++ +
+XXXXXXXXXXXXXXXXXXX  + + + +   +                +
+                      + + +    + ++++++++++++++++
+                     + + + +   +                +
+                      + + +    ++++++++++++++++ +
+                       + + +   +                +
+                        + +    + ++++++++++++++++
++ + + + + + + + + + + +  + +   +                +
+ + + + + + + + + + + + +  +    ++++++++++++++++ +
++ + + + + + + + + + + + +  +   +                +
+A+A+A+A+A+ + + + + + + + +     + ++++++++++++++++
+AAAAAAAA                       +                +
+                               ++++++++++++++++ +
+                               +                +
+++++++++++++++++++++++++ +++++++ ++++++++++++++++
+ +M  M        M+  +M +M   M+   +                +
+  +    M+ +    M+ +   +   +M+  ++++++++++++++++ +
+   +   +   +M    ++    + +  M+ +                +
+    +M+M M M+    M+M         M++ ++++++++++++++++
+     + +   + +M  +M+   +   M +++                +
+    +   +M+   +     + +M+M   +M++++++++++++++++ +
+   +     +     +M++     M+  M+ +                +
+  +             +M  +    ++M+M + ++++++++++++++++
+ +               +M+      M++  + +   +   +     8+
++                 +M   M      M+   +   +       X+
++++++++++++++++++++++++++++++++++++++++++++++++++
#end