#domain
hospital
#levelname
trauMA
#colors
pink: 1,O
red: N,2
brown: S,6
orange: 4,I
green: B,0
blue: D,3
purple: G,5
#initial
++++++++++++++++++++++++++++++++++++++++++++++++++
+                                                +
+ ++++++++++++++++++++++++++++++++++++++++++++++ +
+ ++++++++++++++++++++++++++++++++++++++++++++++ +
+ ++++++++++++++++++++++++++++++++++++++++++++++ +
+ +++++++++++++++++++++++++++++1  +++ N +++   ++ +
+ +++++++++++++++++++++++++++++   S+    ++     + +
+ ++ ++++++++++++++++++++++++++ +     +4+  +++   +
+ ++ ++++++++++++++++++++++++++ ++   ++ + +++++ ++
+N     + +    ++    +++ +++++ + +++ +++ +       ++
+ ++ +++   ++    ++  ++I+++++ + +++++++ + +++++ ++
+ ++ ++++ +++++ ++++ ++ +++++ + +++++++ + +++++ ++
+ ++ ++++ +++++B++++ ++ +++++ + +++++++ + +++++ ++
+ ++ ++++ +++++ ++++  + D+++G + +++++++ + +++++ ++
+5++ 0++  +++++  ++ 2 +   +   + +++++++ + +++++ ++
+ +++    +++++++    + O +   +   +++++++   +++++S++
+ +++++++++++++++++++++++++++++++++++++++++++++6++
+ ++++++++++++++++++++++++++++++++++++++++++++  ++
+                                           3  +++
++++++++++++++++++++++++++++++++++++++++++++++++++
#goal
++++++++++++++++++++++++++++++++++++++++++++++++++
+                                                +
+ ++++++++++++++++++++++++++++++++++++++++++++++ +
+ ++++++++++++++++++++++++++++++++++++++++++++++ +
+ ++++++++++++++++++++++++++++++++++++++++++++++ +
+ +++++++++++++++++++++++++++++   +++   +++   ++ +
+ +++++++++++++++++++++++++++++    +    ++     + +
+ ++ ++++++++++++++++++++++++++ +     + +  +++   +
+ ++ ++++++++++++++++++++++++++ ++   ++ + +++++ ++
+   B  + + O  ++  N +++D+++++I+ +++N+++ +   G   ++
+ ++ +++   ++    ++  ++ +++++ + +++++++ + +++++ ++
+ ++ ++++ +++++ ++++ ++ +++++ + +++++++ + +++++ ++
+ ++ ++++ +++++ ++++ ++ +++++ + +++++++ + +++++ ++
+ ++ ++++ +++++ ++++  +  +++  + +++++++ + +++++ ++
+ ++  ++  +++++  ++   +   +   + +++++++ + +++++ ++
+ +++    +++++++    +   +   +   +++++++   +++++ ++
+ +++++++++++++++++++++++++++++++++++++++++++++ ++
+ ++++++++++++++++++++++++++++++++++++++++++++  ++
+                                              +++
++++++++++++++++++++++++++++++++++++++++++++++++++
#end