#domain
hospital
#levelname
TriSplit
#colors
pink: B,1
brown: 8,T,7,9,U,D
orange: A,3
red: 0
blue: C,2
green: 4,I,P
lightblue: 6
grey: 5
#initial
+++++++++++++++++++++++++++
+++ B1  +++    +   8      +
+++++++ +++    ++++++     +
+++ A3   0     +          +
+++++++ +++    +  T       +
+++ C2  ++++++++        7 +
++++++++++++++++          +
+++++ ++++++ +++      +++ +
++++4I 6 5  P  +      +++ +
+++++++ + ++++++      +++ +
++++++++++++++++          +
+     9            +    + +
+   +              ++ U + +
+   ++              +  +  +
+ D       +++             +
+         ++              +
+++++++++++++++++++++++++++
#goal
+++++++++++++++++++++++++++
+++     +++   B+          +
+++++++ +++   A++++++     +
+++           C+          +
+++++++ +++    +          +
+++     ++++++++          +
++++++++++++++++          +
+++++ ++++++ +++      +++ +
++++     5    I+      +++ +
+++++++ + ++++++      +++ +
++++++++++++++++          +
+                  +    + +
+   +              ++   + +
+   ++              +  +  +
+         +++             +
+         ++   DTU        +
+++++++++++++++++++++++++++
#end