#domain
hospital
#levelname
TwoPlayer
#colors
red: 0, A
blue: 1, B
green: 2, C
#initial
++++++++++++++++++++++++++++++++
+   B   ++   C   ++           A+
+ 0     ++ 1     ++ 2          +
+       ++       ++            +
+++ +++++++ +++++++ +++++++ ++++
+                              +
+   +++   +++   +++   +++   +++
+                              +
+++  +++++++  +++++++  ++++++++
+                              +
+   ++++++   ++++++   ++++++   +
+                              +
++++++++++++++++++++++++++++++++
#goal
++++++++++++++++++++++++++++++++
+       ++       ++            +
+       ++       ++            +
+       ++       ++            +
+++ +++++++ +++++++ +++++++ ++++
+                              +
+   +++   +++   +++   +++   +++
+                              +
+++  +++++++  +++++++  ++++++++
+                              +
+ A ++++++ B ++++++ C ++++++   +
+                              +
++++++++++++++++++++++++++++++++
#end