#domain
hospital
#levelname
HalfWardRush
#colors
green: 0
orange: 1, E
#initial
++++++++++++++++++++++++++++++++++++++++++
+                                        +
+                          1      0      +
+ ++++++++++++++++++++ +++++++++++E+++++++
+                +   + +                 +
+                + +++ +                 +
+                + +   +                 +
+                + +++ +                 +
+                    + +                 +
+                    + ++                +
+                    +  +                +
+                    + ++                +
+                    + +                 +
++++++++++++++++++++++ +++++++++++++++++++
+                                        +
+                                        +
+                                        +
+                                        +
++++++++++++++++++++++++++++++++++++++++++
#goal
++++++++++++++++++++++++++++++++++++++++++
+                                        +
+                                        +
+ ++++++++++++++++++++ +++++++++++ +++++++
+                +   + +0                +
+                + +++ +                 +
+                + +   +                 +
+                + +++ +                 +
+                    + +                 +
+                    + ++                +
+                    +  +                +
+                    + ++                +
+                    + +                 +
++++++++++++++++++++++ +++++++++++++++++++
+1                                       +
+                                        +
+                                        +
+                                        +
++++++++++++++++++++++++++++++++++++++++++
#end
