#domain
hospital
#levelname
MediumWardRush
#colors
green: 0, C
orange: 1, E
red: 2, A
blue: 3, B
pink: 4, D
#initial
++++++++++++++++++++++++++++++++++++++++++
+                                        +
+                                        +
+ ++++++++++++++++++++B+++++++++++A+++++++
+    4   D       +   + +                 +
+                + +++ +                 +
+                + +   +                 +
+                +3+++ +                 +
+                    + +                 +
+                    + ++                +
+                    +  +                +
+                    + ++                +
+                    + +                 +
++++++++++++++++++++++C+++++++++++++++++++
+                    1E2                 +
+                                        +
+                                        +
+      0                                 +
++++++++++++++++++++++++++++++++++++++++++
#goal
++++++++++++++++++++++++++++++++++++++++++
+                                        +
+                                       D+
+ ++++++++++++++++++++ +++++++++++E+++++++
+                +  B+ +                A+
+                + +++ +                 +
+                + +3  +                 +
+                + +++ +                 +
+                    + +                 +
+                    + ++                +
+                    +  +                +
+                    + ++                +
+                    + +2                +
++++++++++++++++++++++ +++++++++++++++++++
+01                                      +
+                                        +
+                                        +
+                                        +
++++++++++++++++++++++++++++++++++++++++++
#end
