#domain
hospital
#levelname
EasyWardRush
#colors
green: 0, E
#initial
++++++++++++++++++++++++++++++++++++++++++
+                                        +
+                                        +
+ ++++++++++++++++++++ +++++++++++ +++++++
+                +   + +                 +
+                + +++ +                 +
+                + +   +                 +
+                + +++ +                 +
+                    + +                 +
+                    + ++                +
+                    +  +                +
+                    + ++                +
+                    +E+                 +
++++++++++++++++++++++E+++++++++++++++++++
+                    0E                  +
+                                        +
+                                        +
+                                        +
++++++++++++++++++++++++++++++++++++++++++
#goal
++++++++++++++++++++++++++++++++++++++++++
+                                        +
+                                        +
+ ++++++++++++++++++++ +++++++++++E+++++++
+                +   + +                 +
+                + +++ +                 +
+                + +   +                 +
+                + +++ +                 +
+                    + +                 +
+                    + ++                +
+                    +  +                +
+                    + ++                +
+                    + +                 +
++++++++++++++++++++++ +++++++++++++++++++
+0                                       +
+                                        +
+                                        +
+                                        +
++++++++++++++++++++++++++++++++++++++++++
#end
