#domain
hospital
#levelname
WardRush
#colors
green: 0, C
orange: 1, E
red: 2, A
blue: 3, B
pink: 4, D
cyan: 5, F
purple: 6, G
brown: 7, H
#initial
++++++++++++++++++++++++++++++++++++++++++
+                                        +
+                                        +
+ ++++++++++++++++++++B+++++++++++A+++++++
+    4   D       +   + +                 +
+                + +++ +                 +
+                + +   +                 +
+                +3+++ +                 +
+                    + +                 +
+                    + ++                +
+       G            +  +                +
+                    + ++                +
+F     567          H+ +                 +
++++++++++++++++++++++C+++++++++++++++++++
+                    1E2                 +
+                                        +
+                                        +
+      0                                 +
++++++++++++++++++++++++++++++++++++++++++
#goal
++++++++++++++++++++++++++++++++++++++++++
+                                        +
+                                       D+
+ ++++++++++++++++++++ +++++++++++E+++++++
+                +  B+ +                A+
+                + +++ +                 +
+                + +   +                 +
+                + +++ +                 +
+                    + +3                +
+                    + ++                +
+G                   +  +                +
+F      6           H+ ++                +
+      5 7           + +2                +
++++++++++++++++++++++ +++++++++++++++++++
+01                                      +
+                                        +
+                                        +
+                                        +
++++++++++++++++++++++++++++++++++++++++++
#end
