#domain
hospital
#levelname
WardRush
#colors
red: 0, A
blue: 1, B
green: 2, C
purple: 3, D
orange: 4, E
pink: 5, F
#initial
++++++++++++++++++++++++++++++++++++++++++
+                     D                  +
+                                        +
+ ++++++++++++++++++++ +++++++++++ +++++++
+                +  5+ +                 +
+                + +++ +                 +
+                + +   +                 +
+                + +++B+                 +
+                    + +                 +
+                    + ++                +
+                    +  +                +
+                    + ++                +
+                    + +F                +
++++++++++++++++++++++C+++++++++++++++++++
+      3             4E1                 +
+                                        +
+                                     A  +
+      2                              0  +
++++++++++++++++++++++++++++++++++++++++++
#goal
++++++++++++++++++++++++++++++++++++++++++
+                                        +
+                                        +
+ ++++++++++++++++++++ +++++++++++E+++++++
+                +D F+ +                 +
+                + +++ +                 +
+                + +   +                 +
+                + +++ +                 +
+                    + +                 +
+                    + ++                +
+                    +  +                +
+                    + ++                +
+                    + +                A+
++++++++++++++++++++++ +++++++++++++++++++
+012345                                  +
+                                        +
+                                        +
+                                        +
++++++++++++++++++++++++++++++++++++++++++
#end
